argF	Biosynthesis
argG	Biosynthesis
argH	Biosynthesis
carA	Biosynthesis
carB	Biosynthesis
hisA	Biosynthesis
hisB	Biosynthesis
hisC	Biosynthesis
hisD	Biosynthesis
hisE	Biosynthesis
hisF	Biosynthesis
hisG	Biosynthesis
hisH	Biosynthesis
hisI	Biosynthesis
asd	Biosynthesis
dapA	Biosynthesis
dapB	Biosynthesis
dapC	Biosynthesis
dapD	Biosynthesis
dapE	Biosynthesis
dapF	Biosynthesis
lysA	Biosynthesis
lysC	Biosynthesis
metC	Biosynthesis
metE	Biosynthesis
aroA	Biosynthesis
aroB	Biosynthesis
aroC	Biosynthesis
aroE	Biosynthesis
aroG	Biosynthesis
aroK	Biosynthesis
aroQ	Biosynthesis
aspC	Biosynthesis
thrB	Biosynthesis
thrC	Biosynthesis
thrA	Biosynthesis
trpA	Biosynthesis
trpB	Biosynthesis
trpC	Biosynthesis
trpD	Biosynthesis
trpE	Biosynthesis
trpF	Biosynthesis
trpG	Biosynthesis
dnaB	Genetic_information_processing
dnaE	Genetic_information_processing
dnaG	Genetic_information_processing
dnaN	Genetic_information_processing
dnaQ	Genetic_information_processing
dnaX	Genetic_information_processing
holB	Genetic_information_processing
ssb	Genetic_information_processing
rho	Genetic_information_processing
rpoA	Genetic_information_processing
rpoB	Genetic_information_processing
rpoC	Genetic_information_processing
rpoD	Genetic_information_processing
era	Genetic_information_processing
ybeY	Genetic_information_processing
rlmE	Genetic_information_processing
rluA	Genetic_information_processing
rluC	Genetic_information_processing
rsmA	Genetic_information_processing
rsmD	Genetic_information_processing
rsmH	Genetic_information_processing
fmt	Genetic_information_processing
gatA	Genetic_information_processing
gatB	Genetic_information_processing
miaB	Genetic_information_processing
mnmA	Genetic_information_processing
mnmE	Genetic_information_processing
mnmG	Genetic_information_processing
smpB	Genetic_information_processing
tsaD	Genetic_information_processing
def	Genetic_information_processing
frr	Genetic_information_processing
fusA	Genetic_information_processing
infA	Genetic_information_processing
infB	Genetic_information_processing
infC	Genetic_information_processing
prfA	Genetic_information_processing
prfB	Genetic_information_processing
tsf	Genetic_information_processing
tufA	Genetic_information_processing
16s_rRNA	Genetic_information_processing
23s_rRNA	Genetic_information_processing
5s_rRNA	Genetic_information_processing
aspS	Genetic_information_processing
glnS	Genetic_information_processing
gltX	Genetic_information_processing
glyQ	Genetic_information_processing
ileS	Genetic_information_processing
leuS	Genetic_information_processing
lysS	Genetic_information_processing
metG	Genetic_information_processing
pheS	Genetic_information_processing
proS	Genetic_information_processing
tilS	Genetic_information_processing
trpS	Genetic_information_processing
tyrS	Genetic_information_processing
rplA	Genetic_information_processing
rplB	Genetic_information_processing
rplC	Genetic_information_processing
rplD	Genetic_information_processing
rplE	Genetic_information_processing
rplF	Genetic_information_processing
rplJ	Genetic_information_processing
rplK	Genetic_information_processing
rplL	Genetic_information_processing
rplM	Genetic_information_processing
rplN	Genetic_information_processing
rplO	Genetic_information_processing
rplP	Genetic_information_processing
rplQ	Genetic_information_processing
rplR	Genetic_information_processing
rplS	Genetic_information_processing
rplT	Genetic_information_processing
rplU	Genetic_information_processing
rplV	Genetic_information_processing
rplW	Genetic_information_processing
rplX	Genetic_information_processing
rplY	Genetic_information_processing
rpmA	Genetic_information_processing
rpmB	Genetic_information_processing
rpmE	Genetic_information_processing
rpmF	Genetic_information_processing
rpmG	Genetic_information_processing
rpmH	Genetic_information_processing
rpmI	Genetic_information_processing
rpmJ	Genetic_information_processing
rpsA	Genetic_information_processing
rpsB	Genetic_information_processing
rpsC	Genetic_information_processing
rpsD	Genetic_information_processing
rpsE	Genetic_information_processing
rpsF	Genetic_information_processing
rpsG	Genetic_information_processing
rpsH	Genetic_information_processing
rpsI	Genetic_information_processing
rpsJ	Genetic_information_processing
rpsK	Genetic_information_processing
rpsL	Genetic_information_processing
rpsM	Genetic_information_processing
rpsN	Genetic_information_processing
rpsO	Genetic_information_processing
rpsP	Genetic_information_processing
rpsQ	Genetic_information_processing
rpsR	Genetic_information_processing
rpsS	Genetic_information_processing
clpP	Genetic_information_processing
clpX	Genetic_information_processing
dnaJ	Genetic_information_processing
dnaK	Genetic_information_processing
groEL	Genetic_information_processing
groES	Genetic_information_processing
grpE	Genetic_information_processing
iscS	Metabolism
iscU	Metabolism
lipA	Metabolism
lpd	Metabolism
maeB	Metabolism
metF	Metabolism
prsA	Metabolism
rpiA	Metabolism
serB	Metabolism
sucA	Metabolism
sucB	Metabolism
trxA	Metabolism
erpA	Metabolism
ygjE	Other